047000000600008000080710400300056000002000900000290007003071050000300001000000690
900020500000000084000653090009005701000000000702300400090417000520000000004060003
000005010600010800010480007000000920004601500032000000200058070009070005080200000
000008000800000403094005010400080357000000000539070004040700580301000009000600000
000020300004008900090001050005000090019030470030000100070500060006100200001070000
604071008000004030000002750300000000015000280000000007023100000070400000800260403
080079000000500094000100370003400006040000010500001800091002000270005000000890060
070106002000009000000350806002000580000040000018000400304091000000400000700508020
003400008000000306052700000000060907006090800207080000000005630604000000500001400
050690700000000005300100600000005204280000093401900000008004001600000000007081050
004510000010049000063007000300070800500000009008050001000100720000790080000085100
000006093000000000018003720001020000503000804000060200074500930000000000850200000
000070000726003000000402530050700002001000300600008010095306000000800649000010000
890006000050740003004000000000000306009301400708000000000000900100059070000400068
006000040000070002020810005050600300007020900003005080600049070100050000030000200
000000000060230070800009054600007020900103007070500008290400001040015090000000000
240005000063000078000007000790030000004208300000010056000100000920000830000800069
900005400800000000030019002040700100307000905006003070400980010000000007001600009
000010008350400000000300709070800024100000006920006080204009000000004061600020000
905007008300020000080000760052090000700000004000080270093000080000050007200600509
000006301005001006000090200000800060830000014060005000008050000200100800509700000
008000600000900007300020510904200700000010000007006108075080001400009000001000300
700980050428100900000000000170000200000708000006000043000000000004005367050026009
300070801600300900000100000060000400870000093004000060000008000002006009103090005
700060090600200300050000007060000003009325400300000010400000060007001008030080001
890006300050039070000000500000057001000000000100460000005000000010920060002700048
020700000010006200980000000004062007800070001200980600000000039009500070000003060
500040000001002508000000630070005100805000307003600080057000000608300400000020009
006705020080004000700200960100000030400000009020000001048003006000800070050406100
060050000000000510001009820005260000300040007000098200059800100034000000000070040
009060000074009001000304000500600800092000670001007002000708000700400350000030700
800900300000800500042000790050030004000509000300060020027000410003001000009007003
000103600070000001605070000503008004000050000900400805000090703400000080007201000
060030000780009040004000209307080000090000050000040903608000400030200087000070090
004000060600800500720060000050010400030502070007080030000020016001004008080000300
008090001000051008620070000080002000204000703000900050000020064800430000700060900
300050000107002900040800000016000000095060470000000280000006040004900708000040003
800003000170049000043000180096700000000000000000006540038000450000980021000400006
000060095008300000004000603800206000100050007000804009607000300000007500350040000
000300060040009800200010000089002300006030400003500910000060001008200030010003000
002008564000000000700052030004000083000503000690000100020140007000000000139700600
080000502600003400050900070000005008009000700100400000070004020001300007502000060
000305900005000001000124603003000095000000000280000100308792000400000800009801000
000300000000070903150809000007600030800000002090005100000107085604090000000003000
038009005000004000704203000005028000600000009000940300000607201000800000100400760
042097000000100000030406005209000300000080000008000206300209050000008000000610870
000008090004060001060940800000000038400207005180000000006095020900020700020400000
000900000320001060481002000000620008700000003900073000000100357070300024000007000
067300000000500600000004210050409030200000007030207060089100000002008000000005890
000016009000030078904500000095000004001000800300000610000001302140080000500340000
800000000003600000070090200050007000000045700000100030001000068008500010090000400