437806201010030804000000530009108020000090000080305100026000000703010050805903712
000067009137090000650130040070400000241903678000006050060028094000010532900340000
034900501910020000000100096601702030370000018020501604250003000000050083403006750
050400103000000070026030408042070900509301207008060340601020590090000000805004060
830900001006302004070806000000000492290104067487000000000601040100408200600003079
750006090000080041090010256600002080029060170080700009874050030910070000030400017
003608700000004501700905280200003690060090010091800007076309005408200000002506100
510690008490800500000500107059070001080306050100050240908004000005009072700085064
053090001090075200100802000820006000360748025000500083000403007001250090500080360
940100706200800450000003800683014000700090004000260385004900000079001002802006043
019000004037605012200004000060582003000906000700413060000800006640307280300000140
504290030079045068200070005010000080040608070020000050700080009450910620090062807
125408039097000010830100000040900600008306100002005090000002067070000580560704923
700000481003010070210980006060173000300408005000596030800041062030060500647000003
000201060000058701005607340026000159900000003154000670081409200203860000090103000
090000700000076000000398145610050204020000080803010057589123000000460000001000020
002097080900300700000000591600742008720805014800913007549000000007006009080130400
000149080003250006204008001009010005046000130100070600400700809900065700050891000
854600000060010504970000080030104050009725300080906010090000037103070040000001925
708930004000008009306000207040089320009020600031450070107000803900800000400091706
020400578005001400000508003037980100040000050006052340400306000001800900379005080
008905000030012000001630475059023000300080007000190540963074200000350060000201800
580601020031405000600980000756000890400000001012000637000096002000204970040103068
001060034050409060000102007502047100106000705009210603400901000070304010910020400
071008402934700080600000070009050030203804107040070200090000008050007916306900720
037608152010000074000001630900007080100903006070200005094500000260000040753804290
603017900807003600000004008000300100379201584008009000400100000002900401005470209
000704900034905806000000245000249030000000000060518000523000000608107390009302000
080029003200307600007040920870000009000618000100000046095080100001205008400960050
097040500605001002000506080506080000204010607000020108040709000700100403009060870
000002507800000004970608203082067100007050300004230760209506071700000006406100000
009006030070039250683005000500300470000417000046002001000500123012780060030600800
065080001170050003002000047200047089400306005610590004920000700700010096500070310
030059280008007000740013000314020908000000000805090342000180079000900500029570010
064003000908076020050204680790800000800307001000002075043609050070430106000700340
300207800045000020700501034800005040009803500010400003150309002070000190004102006
001004020030009000070650091008506109052040760603807200120065080000900070080700500
060030900002090001008405007879003012000218000620500483200904100300080700004060090
032009008064008000000000930450920780016403590089071064095000000000800140300100670
530019008000600002800200900017802500905040201008901360003004005700006000200190036
054100000316205480708000100002800009500409001600003800007000503039702648000006970
009203005053080000280071603508600000300807006000004807807130049000040160400905700
008004170975300006006000000687030095000829000240050813000000600700006942062900300
200041009040000150501006003050000604063000590908000020100600908094000070800730005
020800600083070290670509004040100060056000940090006070900204038064030150008005020
805490001302008090000006842000004058026000930980200000239600000010300709600019403
032409760640300090790010003004003900020000050003800200300020079050008034076901580
000901700900050008030000492260039507050060020708510034412000080600020005005608000
400008561080305002200000843007080050000709000060050400752000006800602070196500004
301007050280504001095602000920000065000709000740000089000308510100905026050100907