300816090900030000000900703006500000780000059000004200809005000000040006040368005
000000070004380001050007623300018000000070000000250008516800090800091400070000000
500001000000070300810609500029000006040000030700000820002506043007090000000300001
500608000002005041060000000000503907605000104708106000000000070240700500000904002
800700301000010080029530000050000000016309470000000060000045890040080000305007004
000000006400708900000001073090000025050694080740000030260100000004209007100000000
600583000300000000050900060270000040006435200080000095090007080000000001000164002
070080005010009008000054690400000010150000082090000003062930000500400030300010070
000002086005100030000080090000400825004000700652001000070010000060008300920300000
100090208508000010400008000000106020002903800080407000000600005060000402307040009
007002050000043100006000040600400095002000300890007006060000400001390000080200700
053020609000900700020004000070600090500000006060001080000300040006007000205040360
200400000000038056090005003047001000006000800000800940400700080370180000000004002
000015800840300000000800307090200100560000034004003070301008000000001089008460000
400050070000037900000008001000001250078000160056900000900800000005720000030060007
003000040907080000008100500006805000704060108000704300001003200000050903080000400
057003010400009030300504200040000700000901000002000080003105006070200001060700940
000823074600000091000000800000200709000341000402006000009000000230000006870592000
200009004600040001040520900760000000020807040000000092009064080400090005800300009
010075360000340500000000007050002900420000078009100040800000000005026000064530080
105003000020000050046090300560400000008030600000007014003010480070000060000800203
560040002700001630030005000005000809020000050301000200000400060096700008200050047
070690000890003000053012000000900073000080000130006000000250390000700082000039040
000500100305090700070000205030807000500409003000601050103000080009010406002008000
005849200000000030406003005200000490100000007079000002600200701040000000002164500
020600015804002000910007020400090500000000000008030009040900081000500702360008050
005910260000000905860500300000040000107000504000090000001004058506000000074053600
048210700000040000200008900000000032087000410630000000001500007000020000009036540
470001800060009040003000000007020003605000402900080700000000300090400060002900054
007100400803045000000008020500000604070050080306000001030900000000710902002003700
040007009000000000350906047600370900007000300003064002810409036000000000900600050
001045020680000000040031700204050900000000000003010502009120070000000041010470200
082300007600480093000000806000050000803000709000030000508000000160075008400008260
006009048700500002020000600289005000007000500000900381003000050800004006470800100
235000001000000470000090058010040600090602030006070040670020000028000000900000523
005020009480310000001000074307800020000000000090002705510000200000081037600050900
000200090602000800093007000000070943005000100917030000000900510009000702060004000
402180000080090700030600800001000080093000540060000900009001050007050030000036102
600080002010600003050020600000005940070104080093800000005010030300002070900050004
300058200000600057005000010020007090050080070040300020030000600980006000004720005
700009010809001700050072003900200600000000000008006002400560030003400109060900008
286000000045000010300005600900026700000704000007910004002800009060000140000000372
400008000085090026300002500807000050000020000020000109003400002910050470000300005
080010900040008060710060300000000605090301070804000000009080056050100040008070030
500040000020010090004002650790004000080000070000200018035900100010060030000070002
100390070009600502060500009004003005000000000300400200200005040506008100010047008
002000010000004720490080006000042000837000492000870000200060041076400000040000500
040000020007860910200500000000007080409000305070400000000006007028059100030000090
800002000503090100000800070102035006006000200900260304060008000008050903000400007
070000020006005300900000800012056000300907004000320510001000002009400100080000060