091800000800500420000030009657000103000179000904000278400020000028007006000008930
300500000040030750098040200000018503010000090705360000007020360069070040000005007
030007140007903800906008007001005000070000020000200400800300906003509200094100030
000605870500008300098370600000002060005000900040900000009061540006200008051403000
000200054000800900037090000760450209080020070102073048000040830004002000320006000
008000069010000405000064200050100080790040053080002090004810000901000020860000500
025890043000540008400200000089000026500000009630000450000002004800074000270058930
207500006059600030600030000005408090000010000060207100000080003090006520500003804
004083002780020000301900000003600007070302040500001900000005604000010073600470200
017090604000004009000006580000530007008020900400069000094600000700200000805010240
000503078730840009002001004000009030900000007040100000500200700400065092260704000
500021060007065000000000500024009016060040020710600390003000000000510600050730002
003005004008037020000004710800000060100402008060000009076300000080290400400700300
032600080608254003900000000004107009006000700200403800000000008100926407060008390
790800000006070000005030672200001090901080704070900001519040300000090400000003057
090040300043500080002900000030680100001000500005024060000001700050009240007060090
800020954200008000005070000009500031050182060180003500000010300000700005561030002
270000081500400000001600300002900570700000004085002100004006800000008003930000046
216005907040970600009002000000130720000000000078024000000200400002053060607400285
000090020095000010430000006082070100009863500003040680900000064050000290060010000
400000000030070280810600009900030800380020045007050003500007096046010030000000002
003009000009030562600080000200600470060493010094007006000040007416070300000800600
006201000081000059200709001054010000000365000000020510300804005860000170000106900
000800000803690000070531080060013540004000300098240060040368020000059607000007000
000004086024760300600005700700000400200647005003000007006300002002079560180400000
000300000004980603000000201207001304005020800301600509109000000508069400000007000
008100003690003500070460900000600050800010007050008000005047060001800032700001400
104706900009000000600004700005340080800651004010028300007400009000000600001209807
000300090008605072700000436193007000000000000000400289816000007370104600020006000
060300000100024060053091700004000300092030640005000200007140890080570002000009050
006000021031070908090280630000820000900000006000054000048092060502030410170000300
003540007001009060000106005290300000005497600000005019300804000050900400900012300
007093042000080009001000006035400000010509030000008150900000200800060000140950700
065000020002056003800003004230005000004060900000400036700200005900670100020000390
090050021200009006010200030430080600800000003001020049050002070300100004140070060
004500010060000000000891340007210800200080007009057400045163000000000050080005700
029605400508000700000001000650700004000569000100004025000900000005000306004308570
700802001000403020100060004098000206007000900301000580800040002010609000600201009
010049052054300090020050000501802700000000000007504206000030060040006930670910020
003905200070010059040600010000007803000000000608500000030001060480030020006209400
004001003030004050009020018700600540000070000015008002140030700060800020800100300
100050002049037500000200309300000000086000240000000003503002000008640920600090007
735049000001070000840000070000005701460010089507400000070000015000050800000180624
071580004000470008900006000809050400060040010004090307000700003700064000600015740
305000180020000030004601007050400010600020003010008050500207300070000040039000705
407000100601400002500009003900700030000205000070006008700900004800002501009000706
003007800050000067000004150006080010200306008040050300034700000160000080009200600
006050900010809000003201050051007000700080002000900610080602300000508060004090200
040068500500900400097450000006180070009000100080094200000037620005002009003610040
000600480020180790007200610000006000105000207000300000058002300094073020012009000